dteday,season,year,month,casual,registered,count,cluster
2011-01-01,Spring,2011,Jan,331,654,985,Cluster Rendah
2011-01-02,Spring,2011,Jan,131,670,801,Cluster Rendah
2011-01-03,Spring,2011,Jan,120,1229,1349,Cluster Rendah
2011-01-04,Spring,2011,Jan,108,1454,1562,Cluster Rendah
2011-01-05,Spring,2011,Jan,82,1518,1600,Cluster Rendah
2011-01-06,Spring,2011,Jan,88,1518,1606,Cluster Rendah
2011-01-07,Spring,2011,Jan,148,1362,1510,Cluster Rendah
2011-01-08,Spring,2011,Jan,68,891,959,Cluster Rendah
2011-01-09,Spring,2011,Jan,54,768,822,Cluster Rendah
2011-01-10,Spring,2011,Jan,41,1280,1321,Cluster Rendah
2011-01-11,Spring,2011,Jan,43,1220,1263,Cluster Rendah
2011-01-12,Spring,2011,Jan,25,1137,1162,Cluster Rendah
2011-01-13,Spring,2011,Jan,38,1368,1406,Cluster Rendah
2011-01-14,Spring,2011,Jan,54,1367,1421,Cluster Rendah
2011-01-15,Spring,2011,Jan,222,1026,1248,Cluster Rendah
2011-01-16,Spring,2011,Jan,251,953,1204,Cluster Rendah
2011-01-17,Spring,2011,Jan,117,883,1000,Cluster Rendah
2011-01-18,Spring,2011,Jan,9,674,683,Cluster Rendah
2011-01-19,Spring,2011,Jan,78,1572,1650,Cluster Rendah
2011-01-20,Spring,2011,Jan,83,1844,1927,Cluster Rendah
2011-01-21,Spring,2011,Jan,75,1468,1543,Cluster Rendah
2011-01-22,Spring,2011,Jan,93,888,981,Cluster Rendah
2011-01-23,Spring,2011,Jan,150,836,986,Cluster Rendah
2011-01-24,Spring,2011,Jan,86,1330,1416,Cluster Rendah
2011-01-25,Spring,2011,Jan,186,1799,1985,Cluster Rendah
2011-01-26,Spring,2011,Jan,34,472,506,Cluster Rendah
2011-01-27,Spring,2011,Jan,15,416,431,Cluster Rendah
2011-01-28,Spring,2011,Jan,38,1129,1167,Cluster Rendah
2011-01-29,Spring,2011,Jan,123,975,1098,Cluster Rendah
2011-01-30,Spring,2011,Jan,140,956,1096,Cluster Rendah
2011-01-31,Spring,2011,Jan,42,1459,1501,Cluster Rendah
2011-02-01,Spring,2011,Feb,47,1313,1360,Cluster Rendah
2011-02-02,Spring,2011,Feb,72,1454,1526,Cluster Rendah
2011-02-03,Spring,2011,Feb,61,1489,1550,Cluster Rendah
2011-02-04,Spring,2011,Feb,88,1620,1708,Cluster Rendah
2011-02-05,Spring,2011,Feb,100,905,1005,Cluster Rendah
2011-02-06,Spring,2011,Feb,354,1269,1623,Cluster Rendah
2011-02-07,Spring,2011,Feb,120,1592,1712,Cluster Rendah
2011-02-08,Spring,2011,Feb,64,1466,1530,Cluster Rendah
2011-02-09,Spring,2011,Feb,53,1552,1605,Cluster Rendah
2011-02-10,Spring,2011,Feb,47,1491,1538,Cluster Rendah
2011-02-11,Spring,2011,Feb,149,1597,1746,Cluster Rendah
2011-02-12,Spring,2011,Feb,288,1184,1472,Cluster Rendah
2011-02-13,Spring,2011,Feb,397,1192,1589,Cluster Rendah
2011-02-14,Spring,2011,Feb,208,1705,1913,Cluster Rendah
2011-02-15,Spring,2011,Feb,140,1675,1815,Cluster Rendah
2011-02-16,Spring,2011,Feb,218,1897,2115,Cluster Rendah
2011-02-17,Spring,2011,Feb,259,2216,2475,Cluster Rendah
2011-02-18,Spring,2011,Feb,579,2348,2927,Cluster Rendah
2011-02-19,Spring,2011,Feb,532,1103,1635,Cluster Rendah
2011-02-20,Spring,2011,Feb,639,1173,1812,Cluster Rendah
2011-02-21,Spring,2011,Feb,195,912,1107,Cluster Rendah
2011-02-22,Spring,2011,Feb,74,1376,1450,Cluster Rendah
2011-02-23,Spring,2011,Feb,139,1778,1917,Cluster Rendah
2011-02-24,Spring,2011,Feb,100,1707,1807,Cluster Rendah
2011-02-25,Spring,2011,Feb,120,1341,1461,Cluster Rendah
2011-02-26,Spring,2011,Feb,424,1545,1969,Cluster Rendah
2011-02-27,Spring,2011,Feb,694,1708,2402,Cluster Rendah
2011-02-28,Spring,2011,Feb,81,1365,1446,Cluster Rendah
2011-03-01,Spring,2011,Mar,137,1714,1851,Cluster Rendah
2011-03-02,Spring,2011,Mar,231,1903,2134,Cluster Rendah
2011-03-03,Spring,2011,Mar,123,1562,1685,Cluster Rendah
2011-03-04,Spring,2011,Mar,214,1730,1944,Cluster Rendah
2011-03-05,Spring,2011,Mar,640,1437,2077,Cluster Rendah
2011-03-06,Spring,2011,Mar,114,491,605,Cluster Rendah
2011-03-07,Spring,2011,Mar,244,1628,1872,Cluster Rendah
2011-03-08,Spring,2011,Mar,316,1817,2133,Cluster Rendah
2011-03-09,Spring,2011,Mar,191,1700,1891,Cluster Rendah
2011-03-10,Spring,2011,Mar,46,577,623,Cluster Rendah
2011-03-11,Spring,2011,Mar,247,1730,1977,Cluster Rendah
2011-03-12,Spring,2011,Mar,724,1408,2132,Cluster Rendah
2011-03-13,Spring,2011,Mar,982,1435,2417,Cluster Rendah
2011-03-14,Spring,2011,Mar,359,1687,2046,Cluster Rendah
2011-03-15,Spring,2011,Mar,289,1767,2056,Cluster Rendah
2011-03-16,Spring,2011,Mar,321,1871,2192,Cluster Rendah
2011-03-17,Spring,2011,Mar,424,2320,2744,Cluster Rendah
2011-03-18,Spring,2011,Mar,884,2355,3239,Cluster Sedang
2011-03-19,Spring,2011,Mar,1424,1693,3117,Cluster Rendah
2011-03-20,Spring,2011,Mar,1047,1424,2471,Cluster Rendah
2011-03-21,Summer,2011,Mar,401,1676,2077,Cluster Rendah
2011-03-22,Summer,2011,Mar,460,2243,2703,Cluster Rendah
2011-03-23,Summer,2011,Mar,203,1918,2121,Cluster Rendah
2011-03-24,Summer,2011,Mar,166,1699,1865,Cluster Rendah
2011-03-25,Summer,2011,Mar,300,1910,2210,Cluster Rendah
2011-03-26,Summer,2011,Mar,981,1515,2496,Cluster Rendah
2011-03-27,Summer,2011,Mar,472,1221,1693,Cluster Rendah
2011-03-28,Summer,2011,Mar,222,1806,2028,Cluster Rendah
2011-03-29,Summer,2011,Mar,317,2108,2425,Cluster Rendah
2011-03-30,Summer,2011,Mar,168,1368,1536,Cluster Rendah
2011-03-31,Summer,2011,Mar,179,1506,1685,Cluster Rendah
2011-04-01,Summer,2011,Apr,307,1920,2227,Cluster Rendah
2011-04-02,Summer,2011,Apr,898,1354,2252,Cluster Rendah
2011-04-03,Summer,2011,Apr,1651,1598,3249,Cluster Sedang
2011-04-04,Summer,2011,Apr,734,2381,3115,Cluster Rendah
2011-04-05,Summer,2011,Apr,167,1628,1795,Cluster Rendah
2011-04-06,Summer,2011,Apr,413,2395,2808,Cluster Rendah
2011-04-07,Summer,2011,Apr,571,2570,3141,Cluster Rendah
2011-04-08,Summer,2011,Apr,172,1299,1471,Cluster Rendah
2011-04-09,Summer,2011,Apr,879,1576,2455,Cluster Rendah
2011-04-10,Summer,2011,Apr,1188,1707,2895,Cluster Rendah
2011-04-11,Summer,2011,Apr,855,2493,3348,Cluster Sedang
2011-04-12,Summer,2011,Apr,257,1777,2034,Cluster Rendah
2011-04-13,Summer,2011,Apr,209,1953,2162,Cluster Rendah
2011-04-14,Summer,2011,Apr,529,2738,3267,Cluster Sedang
2011-04-15,Summer,2011,Apr,642,2484,3126,Cluster Rendah
2011-04-16,Summer,2011,Apr,121,674,795,Cluster Rendah
2011-04-17,Summer,2011,Apr,1558,2186,3744,Cluster Sedang
2011-04-18,Summer,2011,Apr,669,2760,3429,Cluster Sedang
2011-04-19,Summer,2011,Apr,409,2795,3204,Cluster Sedang
2011-04-20,Summer,2011,Apr,613,3331,3944,Cluster Sedang
2011-04-21,Summer,2011,Apr,745,3444,4189,Cluster Sedang
2011-04-22,Summer,2011,Apr,177,1506,1683,Cluster Rendah
2011-04-23,Summer,2011,Apr,1462,2574,4036,Cluster Sedang
2011-04-24,Summer,2011,Apr,1710,2481,4191,Cluster Sedang
2011-04-25,Summer,2011,Apr,773,3300,4073,Cluster Sedang
2011-04-26,Summer,2011,Apr,678,3722,4400,Cluster Sedang
2011-04-27,Summer,2011,Apr,547,3325,3872,Cluster Sedang
2011-04-28,Summer,2011,Apr,569,3489,4058,Cluster Sedang
2011-04-29,Summer,2011,Apr,878,3717,4595,Cluster Sedang
2011-04-30,Summer,2011,Apr,1965,3347,5312,Cluster Sedang
2011-05-01,Summer,2011,May,1138,2213,3351,Cluster Sedang
2011-05-02,Summer,2011,May,847,3554,4401,Cluster Sedang
2011-05-03,Summer,2011,May,603,3848,4451,Cluster Sedang
2011-05-04,Summer,2011,May,255,2378,2633,Cluster Rendah
2011-05-05,Summer,2011,May,614,3819,4433,Cluster Sedang
2011-05-06,Summer,2011,May,894,3714,4608,Cluster Sedang
2011-05-07,Summer,2011,May,1612,3102,4714,Cluster Sedang
2011-05-08,Summer,2011,May,1401,2932,4333,Cluster Sedang
2011-05-09,Summer,2011,May,664,3698,4362,Cluster Sedang
2011-05-10,Summer,2011,May,694,4109,4803,Cluster Sedang
2011-05-11,Summer,2011,May,550,3632,4182,Cluster Sedang
2011-05-12,Summer,2011,May,695,4169,4864,Cluster Sedang
2011-05-13,Summer,2011,May,692,3413,4105,Cluster Sedang
2011-05-14,Summer,2011,May,902,2507,3409,Cluster Sedang
2011-05-15,Summer,2011,May,1582,2971,4553,Cluster Sedang
2011-05-16,Summer,2011,May,773,3185,3958,Cluster Sedang
2011-05-17,Summer,2011,May,678,3445,4123,Cluster Sedang
2011-05-18,Summer,2011,May,536,3319,3855,Cluster Sedang
2011-05-19,Summer,2011,May,735,3840,4575,Cluster Sedang
2011-05-20,Summer,2011,May,909,4008,4917,Cluster Sedang
2011-05-21,Summer,2011,May,2258,3547,5805,Cluster Sedang
2011-05-22,Summer,2011,May,1576,3084,4660,Cluster Sedang
2011-05-23,Summer,2011,May,836,3438,4274,Cluster Sedang
2011-05-24,Summer,2011,May,659,3833,4492,Cluster Sedang
2011-05-25,Summer,2011,May,740,4238,4978,Cluster Sedang
2011-05-26,Summer,2011,May,758,3919,4677,Cluster Sedang
2011-05-27,Summer,2011,May,871,3808,4679,Cluster Sedang
2011-05-28,Summer,2011,May,2001,2757,4758,Cluster Sedang
2011-05-29,Summer,2011,May,2355,2433,4788,Cluster Sedang
2011-05-30,Summer,2011,May,1549,2549,4098,Cluster Sedang
2011-05-31,Summer,2011,May,673,3309,3982,Cluster Sedang
2011-06-01,Summer,2011,Jun,513,3461,3974,Cluster Sedang
2011-06-02,Summer,2011,Jun,736,4232,4968,Cluster Sedang
2011-06-03,Summer,2011,Jun,898,4414,5312,Cluster Sedang
2011-06-04,Summer,2011,Jun,1869,3473,5342,Cluster Sedang
2011-06-05,Summer,2011,Jun,1685,3221,4906,Cluster Sedang
2011-06-06,Summer,2011,Jun,673,3875,4548,Cluster Sedang
2011-06-07,Summer,2011,Jun,763,4070,4833,Cluster Sedang
2011-06-08,Summer,2011,Jun,676,3725,4401,Cluster Sedang
2011-06-09,Summer,2011,Jun,563,3352,3915,Cluster Sedang
2011-06-10,Summer,2011,Jun,815,3771,4586,Cluster Sedang
2011-06-11,Summer,2011,Jun,1729,3237,4966,Cluster Sedang
2011-06-12,Summer,2011,Jun,1467,2993,4460,Cluster Sedang
2011-06-13,Summer,2011,Jun,863,4157,5020,Cluster Sedang
2011-06-14,Summer,2011,Jun,727,4164,4891,Cluster Sedang
2011-06-15,Summer,2011,Jun,769,4411,5180,Cluster Sedang
2011-06-16,Summer,2011,Jun,545,3222,3767,Cluster Sedang
2011-06-17,Summer,2011,Jun,863,3981,4844,Cluster Sedang
2011-06-18,Summer,2011,Jun,1807,3312,5119,Cluster Sedang
2011-06-19,Summer,2011,Jun,1639,3105,4744,Cluster Sedang
2011-06-20,Summer,2011,Jun,699,3311,4010,Cluster Sedang
2011-06-21,Fall,2011,Jun,774,4061,4835,Cluster Sedang
2011-06-22,Fall,2011,Jun,661,3846,4507,Cluster Sedang
2011-06-23,Fall,2011,Jun,746,4044,4790,Cluster Sedang
2011-06-24,Fall,2011,Jun,969,4022,4991,Cluster Sedang
2011-06-25,Fall,2011,Jun,1782,3420,5202,Cluster Sedang
2011-06-26,Fall,2011,Jun,1920,3385,5305,Cluster Sedang
2011-06-27,Fall,2011,Jun,854,3854,4708,Cluster Sedang
2011-06-28,Fall,2011,Jun,732,3916,4648,Cluster Sedang
2011-06-29,Fall,2011,Jun,848,4377,5225,Cluster Sedang
2011-06-30,Fall,2011,Jun,1027,4488,5515,Cluster Sedang
2011-07-01,Fall,2011,Jul,1246,4116,5362,Cluster Sedang
2011-07-02,Fall,2011,Jul,2204,2915,5119,Cluster Sedang
2011-07-03,Fall,2011,Jul,2282,2367,4649,Cluster Sedang
2011-07-04,Fall,2011,Jul,3065,2978,6043,Cluster Tinggi
2011-07-05,Fall,2011,Jul,1031,3634,4665,Cluster Sedang
2011-07-06,Fall,2011,Jul,784,3845,4629,Cluster Sedang
2011-07-07,Fall,2011,Jul,754,3838,4592,Cluster Sedang
2011-07-08,Fall,2011,Jul,692,3348,4040,Cluster Sedang
2011-07-09,Fall,2011,Jul,1988,3348,5336,Cluster Sedang
2011-07-10,Fall,2011,Jul,1743,3138,4881,Cluster Sedang
2011-07-11,Fall,2011,Jul,723,3363,4086,Cluster Sedang
2011-07-12,Fall,2011,Jul,662,3596,4258,Cluster Sedang
2011-07-13,Fall,2011,Jul,748,3594,4342,Cluster Sedang
2011-07-14,Fall,2011,Jul,888,4196,5084,Cluster Sedang
2011-07-15,Fall,2011,Jul,1318,4220,5538,Cluster Sedang
2011-07-16,Fall,2011,Jul,2418,3505,5923,Cluster Sedang
2011-07-17,Fall,2011,Jul,2006,3296,5302,Cluster Sedang
2011-07-18,Fall,2011,Jul,841,3617,4458,Cluster Sedang
2011-07-19,Fall,2011,Jul,752,3789,4541,Cluster Sedang
2011-07-20,Fall,2011,Jul,644,3688,4332,Cluster Sedang
2011-07-21,Fall,2011,Jul,632,3152,3784,Cluster Sedang
2011-07-22,Fall,2011,Jul,562,2825,3387,Cluster Sedang
2011-07-23,Fall,2011,Jul,987,2298,3285,Cluster Sedang
2011-07-24,Fall,2011,Jul,1050,2556,3606,Cluster Sedang
2011-07-25,Fall,2011,Jul,568,3272,3840,Cluster Sedang
2011-07-26,Fall,2011,Jul,750,3840,4590,Cluster Sedang
2011-07-27,Fall,2011,Jul,755,3901,4656,Cluster Sedang
2011-07-28,Fall,2011,Jul,606,3784,4390,Cluster Sedang
2011-07-29,Fall,2011,Jul,670,3176,3846,Cluster Sedang
2011-07-30,Fall,2011,Jul,1559,2916,4475,Cluster Sedang
2011-07-31,Fall,2011,Jul,1524,2778,4302,Cluster Sedang
2011-08-01,Fall,2011,Aug,729,3537,4266,Cluster Sedang
2011-08-02,Fall,2011,Aug,801,4044,4845,Cluster Sedang
2011-08-03,Fall,2011,Aug,467,3107,3574,Cluster Sedang
2011-08-04,Fall,2011,Aug,799,3777,4576,Cluster Sedang
2011-08-05,Fall,2011,Aug,1023,3843,4866,Cluster Sedang
2011-08-06,Fall,2011,Aug,1521,2773,4294,Cluster Sedang
2011-08-07,Fall,2011,Aug,1298,2487,3785,Cluster Sedang
2011-08-08,Fall,2011,Aug,846,3480,4326,Cluster Sedang
2011-08-09,Fall,2011,Aug,907,3695,4602,Cluster Sedang
2011-08-10,Fall,2011,Aug,884,3896,4780,Cluster Sedang
2011-08-11,Fall,2011,Aug,812,3980,4792,Cluster Sedang
2011-08-12,Fall,2011,Aug,1051,3854,4905,Cluster Sedang
2011-08-13,Fall,2011,Aug,1504,2646,4150,Cluster Sedang
2011-08-14,Fall,2011,Aug,1338,2482,3820,Cluster Sedang
2011-08-15,Fall,2011,Aug,775,3563,4338,Cluster Sedang
2011-08-16,Fall,2011,Aug,721,4004,4725,Cluster Sedang
2011-08-17,Fall,2011,Aug,668,4026,4694,Cluster Sedang
2011-08-18,Fall,2011,Aug,639,3166,3805,Cluster Sedang
2011-08-19,Fall,2011,Aug,797,3356,4153,Cluster Sedang
2011-08-20,Fall,2011,Aug,1914,3277,5191,Cluster Sedang
2011-08-21,Fall,2011,Aug,1249,2624,3873,Cluster Sedang
2011-08-22,Fall,2011,Aug,833,3925,4758,Cluster Sedang
2011-08-23,Fall,2011,Aug,1281,4614,5895,Cluster Sedang
2011-08-24,Fall,2011,Aug,949,4181,5130,Cluster Sedang
2011-08-25,Fall,2011,Aug,435,3107,3542,Cluster Sedang
2011-08-26,Fall,2011,Aug,768,3893,4661,Cluster Sedang
2011-08-27,Fall,2011,Aug,226,889,1115,Cluster Rendah
2011-08-28,Fall,2011,Aug,1415,2919,4334,Cluster Sedang
2011-08-29,Fall,2011,Aug,729,3905,4634,Cluster Sedang
2011-08-30,Fall,2011,Aug,775,4429,5204,Cluster Sedang
2011-08-31,Fall,2011,Aug,688,4370,5058,Cluster Sedang
2011-09-01,Fall,2011,Sep,783,4332,5115,Cluster Sedang
2011-09-02,Fall,2011,Sep,875,3852,4727,Cluster Sedang
2011-09-03,Fall,2011,Sep,1935,2549,4484,Cluster Sedang
2011-09-04,Fall,2011,Sep,2521,2419,4940,Cluster Sedang
2011-09-05,Fall,2011,Sep,1236,2115,3351,Cluster Sedang
2011-09-06,Fall,2011,Sep,204,2506,2710,Cluster Rendah
2011-09-07,Fall,2011,Sep,118,1878,1996,Cluster Rendah
2011-09-08,Fall,2011,Sep,153,1689,1842,Cluster Rendah
2011-09-09,Fall,2011,Sep,417,3127,3544,Cluster Sedang
2011-09-10,Fall,2011,Sep,1750,3595,5345,Cluster Sedang
2011-09-11,Fall,2011,Sep,1633,3413,5046,Cluster Sedang
2011-09-12,Fall,2011,Sep,690,4023,4713,Cluster Sedang
2011-09-13,Fall,2011,Sep,701,4062,4763,Cluster Sedang
2011-09-14,Fall,2011,Sep,647,4138,4785,Cluster Sedang
2011-09-15,Fall,2011,Sep,428,3231,3659,Cluster Sedang
2011-09-16,Fall,2011,Sep,742,4018,4760,Cluster Sedang
2011-09-17,Fall,2011,Sep,1434,3077,4511,Cluster Sedang
2011-09-18,Fall,2011,Sep,1353,2921,4274,Cluster Sedang
2011-09-19,Fall,2011,Sep,691,3848,4539,Cluster Sedang
2011-09-20,Fall,2011,Sep,438,3203,3641,Cluster Sedang
2011-09-21,Fall,2011,Sep,539,3813,4352,Cluster Sedang
2011-09-22,Fall,2011,Sep,555,4240,4795,Cluster Sedang
2011-09-23,Winter,2011,Sep,258,2137,2395,Cluster Rendah
2011-09-24,Winter,2011,Sep,1776,3647,5423,Cluster Sedang
2011-09-25,Winter,2011,Sep,1544,3466,5010,Cluster Sedang
2011-09-26,Winter,2011,Sep,684,3946,4630,Cluster Sedang
2011-09-27,Winter,2011,Sep,477,3643,4120,Cluster Sedang
2011-09-28,Winter,2011,Sep,480,3427,3907,Cluster Sedang
2011-09-29,Winter,2011,Sep,653,4186,4839,Cluster Sedang
2011-09-30,Winter,2011,Sep,830,4372,5202,Cluster Sedang
2011-10-01,Winter,2011,Oct,480,1949,2429,Cluster Rendah
2011-10-02,Winter,2011,Oct,616,2302,2918,Cluster Rendah
2011-10-03,Winter,2011,Oct,330,3240,3570,Cluster Sedang
2011-10-04,Winter,2011,Oct,486,3970,4456,Cluster Sedang
2011-10-05,Winter,2011,Oct,559,4267,4826,Cluster Sedang
2011-10-06,Winter,2011,Oct,639,4126,4765,Cluster Sedang
2011-10-07,Winter,2011,Oct,949,4036,4985,Cluster Sedang
2011-10-08,Winter,2011,Oct,2235,3174,5409,Cluster Sedang
2011-10-09,Winter,2011,Oct,2397,3114,5511,Cluster Sedang
2011-10-10,Winter,2011,Oct,1514,3603,5117,Cluster Sedang
2011-10-11,Winter,2011,Oct,667,3896,4563,Cluster Sedang
2011-10-12,Winter,2011,Oct,217,2199,2416,Cluster Rendah
2011-10-13,Winter,2011,Oct,290,2623,2913,Cluster Rendah
2011-10-14,Winter,2011,Oct,529,3115,3644,Cluster Sedang
2011-10-15,Winter,2011,Oct,1899,3318,5217,Cluster Sedang
2011-10-16,Winter,2011,Oct,1748,3293,5041,Cluster Sedang
2011-10-17,Winter,2011,Oct,713,3857,4570,Cluster Sedang
2011-10-18,Winter,2011,Oct,637,4111,4748,Cluster Sedang
2011-10-19,Winter,2011,Oct,254,2170,2424,Cluster Rendah
2011-10-20,Winter,2011,Oct,471,3724,4195,Cluster Sedang
2011-10-21,Winter,2011,Oct,676,3628,4304,Cluster Sedang
2011-10-22,Winter,2011,Oct,1499,2809,4308,Cluster Sedang
2011-10-23,Winter,2011,Oct,1619,2762,4381,Cluster Sedang
2011-10-24,Winter,2011,Oct,699,3488,4187,Cluster Sedang
2011-10-25,Winter,2011,Oct,695,3992,4687,Cluster Sedang
2011-10-26,Winter,2011,Oct,404,3490,3894,Cluster Sedang
2011-10-27,Winter,2011,Oct,240,2419,2659,Cluster Rendah
2011-10-28,Winter,2011,Oct,456,3291,3747,Cluster Sedang
2011-10-29,Winter,2011,Oct,57,570,627,Cluster Rendah
2011-10-30,Winter,2011,Oct,885,2446,3331,Cluster Sedang
2011-10-31,Winter,2011,Oct,362,3307,3669,Cluster Sedang
2011-11-01,Winter,2011,Nov,410,3658,4068,Cluster Sedang
2011-11-02,Winter,2011,Nov,370,3816,4186,Cluster Sedang
2011-11-03,Winter,2011,Nov,318,3656,3974,Cluster Sedang
2011-11-04,Winter,2011,Nov,470,3576,4046,Cluster Sedang
2011-11-05,Winter,2011,Nov,1156,2770,3926,Cluster Sedang
2011-11-06,Winter,2011,Nov,952,2697,3649,Cluster Sedang
2011-11-07,Winter,2011,Nov,373,3662,4035,Cluster Sedang
2011-11-08,Winter,2011,Nov,376,3829,4205,Cluster Sedang
2011-11-09,Winter,2011,Nov,305,3804,4109,Cluster Sedang
2011-11-10,Winter,2011,Nov,190,2743,2933,Cluster Rendah
2011-11-11,Winter,2011,Nov,440,2928,3368,Cluster Sedang
2011-11-12,Winter,2011,Nov,1275,2792,4067,Cluster Sedang
2011-11-13,Winter,2011,Nov,1004,2713,3717,Cluster Sedang
2011-11-14,Winter,2011,Nov,595,3891,4486,Cluster Sedang
2011-11-15,Winter,2011,Nov,449,3746,4195,Cluster Sedang
2011-11-16,Winter,2011,Nov,145,1672,1817,Cluster Rendah
2011-11-17,Winter,2011,Nov,139,2914,3053,Cluster Rendah
2011-11-18,Winter,2011,Nov,245,3147,3392,Cluster Sedang
2011-11-19,Winter,2011,Nov,943,2720,3663,Cluster Sedang
2011-11-20,Winter,2011,Nov,787,2733,3520,Cluster Sedang
2011-11-21,Winter,2011,Nov,220,2545,2765,Cluster Rendah
2011-11-22,Winter,2011,Nov,69,1538,1607,Cluster Rendah
2011-11-23,Winter,2011,Nov,112,2454,2566,Cluster Rendah
2011-11-24,Winter,2011,Nov,560,935,1495,Cluster Rendah
2011-11-25,Winter,2011,Nov,1095,1697,2792,Cluster Rendah
2011-11-26,Winter,2011,Nov,1249,1819,3068,Cluster Rendah
2011-11-27,Winter,2011,Nov,810,2261,3071,Cluster Rendah
2011-11-28,Winter,2011,Nov,253,3614,3867,Cluster Sedang
2011-11-29,Winter,2011,Nov,96,2818,2914,Cluster Rendah
2011-11-30,Winter,2011,Nov,188,3425,3613,Cluster Sedang
2011-12-01,Winter,2011,Dec,182,3545,3727,Cluster Sedang
2011-12-02,Winter,2011,Dec,268,3672,3940,Cluster Sedang
2011-12-03,Winter,2011,Dec,706,2908,3614,Cluster Sedang
2011-12-04,Winter,2011,Dec,634,2851,3485,Cluster Sedang
2011-12-05,Winter,2011,Dec,233,3578,3811,Cluster Sedang
2011-12-06,Winter,2011,Dec,126,2468,2594,Cluster Rendah
2011-12-07,Winter,2011,Dec,50,655,705,Cluster Rendah
2011-12-08,Winter,2011,Dec,150,3172,3322,Cluster Sedang
2011-12-09,Winter,2011,Dec,261,3359,3620,Cluster Sedang
2011-12-10,Winter,2011,Dec,502,2688,3190,Cluster Sedang
2011-12-11,Winter,2011,Dec,377,2366,2743,Cluster Rendah
2011-12-12,Winter,2011,Dec,143,3167,3310,Cluster Sedang
2011-12-13,Winter,2011,Dec,155,3368,3523,Cluster Sedang
2011-12-14,Winter,2011,Dec,178,3562,3740,Cluster Sedang
2011-12-15,Winter,2011,Dec,181,3528,3709,Cluster Sedang
2011-12-16,Winter,2011,Dec,178,3399,3577,Cluster Sedang
2011-12-17,Winter,2011,Dec,275,2464,2739,Cluster Rendah
2011-12-18,Winter,2011,Dec,220,2211,2431,Cluster Rendah
2011-12-19,Winter,2011,Dec,260,3143,3403,Cluster Sedang
2011-12-20,Winter,2011,Dec,216,3534,3750,Cluster Sedang
2011-12-21,Spring,2011,Dec,107,2553,2660,Cluster Rendah
2011-12-22,Spring,2011,Dec,227,2841,3068,Cluster Rendah
2011-12-23,Spring,2011,Dec,163,2046,2209,Cluster Rendah
2011-12-24,Spring,2011,Dec,155,856,1011,Cluster Rendah
2011-12-25,Spring,2011,Dec,303,451,754,Cluster Rendah
2011-12-26,Spring,2011,Dec,430,887,1317,Cluster Rendah
2011-12-27,Spring,2011,Dec,103,1059,1162,Cluster Rendah
2011-12-28,Spring,2011,Dec,255,2047,2302,Cluster Rendah
2011-12-29,Spring,2011,Dec,254,2169,2423,Cluster Rendah
2011-12-30,Spring,2011,Dec,491,2508,2999,Cluster Rendah
2011-12-31,Spring,2011,Dec,665,1820,2485,Cluster Rendah
2012-01-01,Spring,2012,Jan,686,1608,2294,Cluster Rendah
2012-01-02,Spring,2012,Jan,244,1707,1951,Cluster Rendah
2012-01-03,Spring,2012,Jan,89,2147,2236,Cluster Rendah
2012-01-04,Spring,2012,Jan,95,2273,2368,Cluster Rendah
2012-01-05,Spring,2012,Jan,140,3132,3272,Cluster Sedang
2012-01-06,Spring,2012,Jan,307,3791,4098,Cluster Sedang
2012-01-07,Spring,2012,Jan,1070,3451,4521,Cluster Sedang
2012-01-08,Spring,2012,Jan,599,2826,3425,Cluster Sedang
2012-01-09,Spring,2012,Jan,106,2270,2376,Cluster Rendah
2012-01-10,Spring,2012,Jan,173,3425,3598,Cluster Sedang
2012-01-11,Spring,2012,Jan,92,2085,2177,Cluster Rendah
2012-01-12,Spring,2012,Jan,269,3828,4097,Cluster Sedang
2012-01-13,Spring,2012,Jan,174,3040,3214,Cluster Sedang
2012-01-14,Spring,2012,Jan,333,2160,2493,Cluster Rendah
2012-01-15,Spring,2012,Jan,284,2027,2311,Cluster Rendah
2012-01-16,Spring,2012,Jan,217,2081,2298,Cluster Rendah
2012-01-17,Spring,2012,Jan,127,2808,2935,Cluster Rendah
2012-01-18,Spring,2012,Jan,109,3267,3376,Cluster Sedang
2012-01-19,Spring,2012,Jan,130,3162,3292,Cluster Sedang
2012-01-20,Spring,2012,Jan,115,3048,3163,Cluster Sedang
2012-01-21,Spring,2012,Jan,67,1234,1301,Cluster Rendah
2012-01-22,Spring,2012,Jan,196,1781,1977,Cluster Rendah
2012-01-23,Spring,2012,Jan,145,2287,2432,Cluster Rendah
2012-01-24,Spring,2012,Jan,439,3900,4339,Cluster Sedang
2012-01-25,Spring,2012,Jan,467,3803,4270,Cluster Sedang
2012-01-26,Spring,2012,Jan,244,3831,4075,Cluster Sedang
2012-01-27,Spring,2012,Jan,269,3187,3456,Cluster Sedang
2012-01-28,Spring,2012,Jan,775,3248,4023,Cluster Sedang
2012-01-29,Spring,2012,Jan,558,2685,3243,Cluster Sedang
2012-01-30,Spring,2012,Jan,126,3498,3624,Cluster Sedang
2012-01-31,Spring,2012,Jan,324,4185,4509,Cluster Sedang
2012-02-01,Spring,2012,Feb,304,4275,4579,Cluster Sedang
2012-02-02,Spring,2012,Feb,190,3571,3761,Cluster Sedang
2012-02-03,Spring,2012,Feb,310,3841,4151,Cluster Sedang
2012-02-04,Spring,2012,Feb,384,2448,2832,Cluster Rendah
2012-02-05,Spring,2012,Feb,318,2629,2947,Cluster Rendah
2012-02-06,Spring,2012,Feb,206,3578,3784,Cluster Sedang
2012-02-07,Spring,2012,Feb,199,4176,4375,Cluster Sedang
2012-02-08,Spring,2012,Feb,109,2693,2802,Cluster Rendah
2012-02-09,Spring,2012,Feb,163,3667,3830,Cluster Sedang
2012-02-10,Spring,2012,Feb,227,3604,3831,Cluster Sedang
2012-02-11,Spring,2012,Feb,192,1977,2169,Cluster Rendah
2012-02-12,Spring,2012,Feb,73,1456,1529,Cluster Rendah
2012-02-13,Spring,2012,Feb,94,3328,3422,Cluster Sedang
2012-02-14,Spring,2012,Feb,135,3787,3922,Cluster Sedang
2012-02-15,Spring,2012,Feb,141,4028,4169,Cluster Sedang
2012-02-16,Spring,2012,Feb,74,2931,3005,Cluster Rendah
2012-02-17,Spring,2012,Feb,349,3805,4154,Cluster Sedang
2012-02-18,Spring,2012,Feb,1435,2883,4318,Cluster Sedang
2012-02-19,Spring,2012,Feb,618,2071,2689,Cluster Rendah
2012-02-20,Spring,2012,Feb,502,2627,3129,Cluster Rendah
2012-02-21,Spring,2012,Feb,163,3614,3777,Cluster Sedang
2012-02-22,Spring,2012,Feb,394,4379,4773,Cluster Sedang
2012-02-23,Spring,2012,Feb,516,4546,5062,Cluster Sedang
2012-02-24,Spring,2012,Feb,246,3241,3487,Cluster Sedang
2012-02-25,Spring,2012,Feb,317,2415,2732,Cluster Rendah
2012-02-26,Spring,2012,Feb,515,2874,3389,Cluster Sedang
2012-02-27,Spring,2012,Feb,253,4069,4322,Cluster Sedang
2012-02-28,Spring,2012,Feb,229,4134,4363,Cluster Sedang
2012-02-29,Spring,2012,Feb,65,1769,1834,Cluster Rendah
2012-03-01,Spring,2012,Mar,325,4665,4990,Cluster Sedang
2012-03-02,Spring,2012,Mar,246,2948,3194,Cluster Sedang
2012-03-03,Spring,2012,Mar,956,3110,4066,Cluster Sedang
2012-03-04,Spring,2012,Mar,710,2713,3423,Cluster Sedang
2012-03-05,Spring,2012,Mar,203,3130,3333,Cluster Sedang
2012-03-06,Spring,2012,Mar,221,3735,3956,Cluster Sedang
2012-03-07,Spring,2012,Mar,432,4484,4916,Cluster Sedang
2012-03-08,Spring,2012,Mar,486,4896,5382,Cluster Sedang
2012-03-09,Spring,2012,Mar,447,4122,4569,Cluster Sedang
2012-03-10,Spring,2012,Mar,968,3150,4118,Cluster Sedang
2012-03-11,Spring,2012,Mar,1658,3253,4911,Cluster Sedang
2012-03-12,Spring,2012,Mar,838,4460,5298,Cluster Sedang
2012-03-13,Spring,2012,Mar,762,5085,5847,Cluster Sedang
2012-03-14,Spring,2012,Mar,997,5315,6312,Cluster Tinggi
2012-03-15,Spring,2012,Mar,1005,5187,6192,Cluster Tinggi
2012-03-16,Spring,2012,Mar,548,3830,4378,Cluster Sedang
2012-03-17,Spring,2012,Mar,3155,4681,7836,Cluster Tinggi
2012-03-18,Spring,2012,Mar,2207,3685,5892,Cluster Sedang
2012-03-19,Spring,2012,Mar,982,5171,6153,Cluster Tinggi
2012-03-20,Spring,2012,Mar,1051,5042,6093,Cluster Tinggi
2012-03-21,Summer,2012,Mar,1122,5108,6230,Cluster Tinggi
2012-03-22,Summer,2012,Mar,1334,5537,6871,Cluster Tinggi
2012-03-23,Summer,2012,Mar,2469,5893,8362,Cluster Tinggi
2012-03-24,Summer,2012,Mar,1033,2339,3372,Cluster Sedang
2012-03-25,Summer,2012,Mar,1532,3464,4996,Cluster Sedang
2012-03-26,Summer,2012,Mar,795,4763,5558,Cluster Sedang
2012-03-27,Summer,2012,Mar,531,4571,5102,Cluster Sedang
2012-03-28,Summer,2012,Mar,674,5024,5698,Cluster Sedang
2012-03-29,Summer,2012,Mar,834,5299,6133,Cluster Tinggi
2012-03-30,Summer,2012,Mar,796,4663,5459,Cluster Sedang
2012-03-31,Summer,2012,Mar,2301,3934,6235,Cluster Tinggi
2012-04-01,Summer,2012,Apr,2347,3694,6041,Cluster Tinggi
2012-04-02,Summer,2012,Apr,1208,4728,5936,Cluster Sedang
2012-04-03,Summer,2012,Apr,1348,5424,6772,Cluster Tinggi
2012-04-04,Summer,2012,Apr,1058,5378,6436,Cluster Tinggi
2012-04-05,Summer,2012,Apr,1192,5265,6457,Cluster Tinggi
2012-04-06,Summer,2012,Apr,1807,4653,6460,Cluster Tinggi
2012-04-07,Summer,2012,Apr,3252,3605,6857,Cluster Tinggi
2012-04-08,Summer,2012,Apr,2230,2939,5169,Cluster Sedang
2012-04-09,Summer,2012,Apr,905,4680,5585,Cluster Sedang
2012-04-10,Summer,2012,Apr,819,5099,5918,Cluster Sedang
2012-04-11,Summer,2012,Apr,482,4380,4862,Cluster Sedang
2012-04-12,Summer,2012,Apr,663,4746,5409,Cluster Sedang
2012-04-13,Summer,2012,Apr,1252,5146,6398,Cluster Tinggi
2012-04-14,Summer,2012,Apr,2795,4665,7460,Cluster Tinggi
2012-04-15,Summer,2012,Apr,2846,4286,7132,Cluster Tinggi
2012-04-16,Summer,2012,Apr,1198,5172,6370,Cluster Tinggi
2012-04-17,Summer,2012,Apr,989,5702,6691,Cluster Tinggi
2012-04-18,Summer,2012,Apr,347,4020,4367,Cluster Sedang
2012-04-19,Summer,2012,Apr,846,5719,6565,Cluster Tinggi
2012-04-20,Summer,2012,Apr,1340,5950,7290,Cluster Tinggi
2012-04-21,Summer,2012,Apr,2541,4083,6624,Cluster Tinggi
2012-04-22,Summer,2012,Apr,120,907,1027,Cluster Rendah
2012-04-23,Summer,2012,Apr,195,3019,3214,Cluster Sedang
2012-04-24,Summer,2012,Apr,518,5115,5633,Cluster Sedang
2012-04-25,Summer,2012,Apr,655,5541,6196,Cluster Tinggi
2012-04-26,Summer,2012,Apr,475,4551,5026,Cluster Sedang
2012-04-27,Summer,2012,Apr,1014,5219,6233,Cluster Tinggi
2012-04-28,Summer,2012,Apr,1120,3100,4220,Cluster Sedang
2012-04-29,Summer,2012,Apr,2229,4075,6304,Cluster Tinggi
2012-04-30,Summer,2012,Apr,665,4907,5572,Cluster Sedang
2012-05-01,Summer,2012,May,653,5087,5740,Cluster Sedang
2012-05-02,Summer,2012,May,667,5502,6169,Cluster Tinggi
2012-05-03,Summer,2012,May,764,5657,6421,Cluster Tinggi
2012-05-04,Summer,2012,May,1069,5227,6296,Cluster Tinggi
2012-05-05,Summer,2012,May,2496,4387,6883,Cluster Tinggi
2012-05-06,Summer,2012,May,2135,4224,6359,Cluster Tinggi
2012-05-07,Summer,2012,May,1008,5265,6273,Cluster Tinggi
2012-05-08,Summer,2012,May,738,4990,5728,Cluster Sedang
2012-05-09,Summer,2012,May,620,4097,4717,Cluster Sedang
2012-05-10,Summer,2012,May,1026,5546,6572,Cluster Tinggi
2012-05-11,Summer,2012,May,1319,5711,7030,Cluster Tinggi
2012-05-12,Summer,2012,May,2622,4807,7429,Cluster Tinggi
2012-05-13,Summer,2012,May,2172,3946,6118,Cluster Tinggi
2012-05-14,Summer,2012,May,342,2501,2843,Cluster Rendah
2012-05-15,Summer,2012,May,625,4490,5115,Cluster Sedang
2012-05-16,Summer,2012,May,991,6433,7424,Cluster Tinggi
2012-05-17,Summer,2012,May,1242,6142,7384,Cluster Tinggi
2012-05-18,Summer,2012,May,1521,6118,7639,Cluster Tinggi
2012-05-19,Summer,2012,May,3410,4884,8294,Cluster Tinggi
2012-05-20,Summer,2012,May,2704,4425,7129,Cluster Tinggi
2012-05-21,Summer,2012,May,630,3729,4359,Cluster Sedang
2012-05-22,Summer,2012,May,819,5254,6073,Cluster Tinggi
2012-05-23,Summer,2012,May,766,4494,5260,Cluster Sedang
2012-05-24,Summer,2012,May,1059,5711,6770,Cluster Tinggi
2012-05-25,Summer,2012,May,1417,5317,6734,Cluster Tinggi
2012-05-26,Summer,2012,May,2855,3681,6536,Cluster Tinggi
2012-05-27,Summer,2012,May,3283,3308,6591,Cluster Tinggi
2012-05-28,Summer,2012,May,2557,3486,6043,Cluster Tinggi
2012-05-29,Summer,2012,May,880,4863,5743,Cluster Sedang
2012-05-30,Summer,2012,May,745,6110,6855,Cluster Tinggi
2012-05-31,Summer,2012,May,1100,6238,7338,Cluster Tinggi
2012-06-01,Summer,2012,Jun,533,3594,4127,Cluster Sedang
2012-06-02,Summer,2012,Jun,2795,5325,8120,Cluster Tinggi
2012-06-03,Summer,2012,Jun,2494,5147,7641,Cluster Tinggi
2012-06-04,Summer,2012,Jun,1071,5927,6998,Cluster Tinggi
2012-06-05,Summer,2012,Jun,968,6033,7001,Cluster Tinggi
2012-06-06,Summer,2012,Jun,1027,6028,7055,Cluster Tinggi
2012-06-07,Summer,2012,Jun,1038,6456,7494,Cluster Tinggi
2012-06-08,Summer,2012,Jun,1488,6248,7736,Cluster Tinggi
2012-06-09,Summer,2012,Jun,2708,4790,7498,Cluster Tinggi
2012-06-10,Summer,2012,Jun,2224,4374,6598,Cluster Tinggi
2012-06-11,Summer,2012,Jun,1017,5647,6664,Cluster Tinggi
2012-06-12,Summer,2012,Jun,477,4495,4972,Cluster Sedang
2012-06-13,Summer,2012,Jun,1173,6248,7421,Cluster Tinggi
2012-06-14,Summer,2012,Jun,1180,6183,7363,Cluster Tinggi
2012-06-15,Summer,2012,Jun,1563,6102,7665,Cluster Tinggi
2012-06-16,Summer,2012,Jun,2963,4739,7702,Cluster Tinggi
2012-06-17,Summer,2012,Jun,2634,4344,6978,Cluster Tinggi
2012-06-18,Summer,2012,Jun,653,4446,5099,Cluster Sedang
2012-06-19,Summer,2012,Jun,968,5857,6825,Cluster Tinggi
2012-06-20,Summer,2012,Jun,872,5339,6211,Cluster Tinggi
2012-06-21,Fall,2012,Jun,778,5127,5905,Cluster Sedang
2012-06-22,Fall,2012,Jun,964,4859,5823,Cluster Sedang
2012-06-23,Fall,2012,Jun,2657,4801,7458,Cluster Tinggi
2012-06-24,Fall,2012,Jun,2551,4340,6891,Cluster Tinggi
2012-06-25,Fall,2012,Jun,1139,5640,6779,Cluster Tinggi
2012-06-26,Fall,2012,Jun,1077,6365,7442,Cluster Tinggi
2012-06-27,Fall,2012,Jun,1077,6258,7335,Cluster Tinggi
2012-06-28,Fall,2012,Jun,921,5958,6879,Cluster Tinggi
2012-06-29,Fall,2012,Jun,829,4634,5463,Cluster Sedang
2012-06-30,Fall,2012,Jun,1455,4232,5687,Cluster Sedang
2012-07-01,Fall,2012,Jul,1421,4110,5531,Cluster Sedang
2012-07-02,Fall,2012,Jul,904,5323,6227,Cluster Tinggi
2012-07-03,Fall,2012,Jul,1052,5608,6660,Cluster Tinggi
2012-07-04,Fall,2012,Jul,2562,4841,7403,Cluster Tinggi
2012-07-05,Fall,2012,Jul,1405,4836,6241,Cluster Tinggi
2012-07-06,Fall,2012,Jul,1366,4841,6207,Cluster Tinggi
2012-07-07,Fall,2012,Jul,1448,3392,4840,Cluster Sedang
2012-07-08,Fall,2012,Jul,1203,3469,4672,Cluster Sedang
2012-07-09,Fall,2012,Jul,998,5571,6569,Cluster Tinggi
2012-07-10,Fall,2012,Jul,954,5336,6290,Cluster Tinggi
2012-07-11,Fall,2012,Jul,975,6289,7264,Cluster Tinggi
2012-07-12,Fall,2012,Jul,1032,6414,7446,Cluster Tinggi
2012-07-13,Fall,2012,Jul,1511,5988,7499,Cluster Tinggi
2012-07-14,Fall,2012,Jul,2355,4614,6969,Cluster Tinggi
2012-07-15,Fall,2012,Jul,1920,4111,6031,Cluster Tinggi
2012-07-16,Fall,2012,Jul,1088,5742,6830,Cluster Tinggi
2012-07-17,Fall,2012,Jul,921,5865,6786,Cluster Tinggi
2012-07-18,Fall,2012,Jul,799,4914,5713,Cluster Sedang
2012-07-19,Fall,2012,Jul,888,5703,6591,Cluster Tinggi
2012-07-20,Fall,2012,Jul,747,5123,5870,Cluster Sedang
2012-07-21,Fall,2012,Jul,1264,3195,4459,Cluster Sedang
2012-07-22,Fall,2012,Jul,2544,4866,7410,Cluster Tinggi
2012-07-23,Fall,2012,Jul,1135,5831,6966,Cluster Tinggi
2012-07-24,Fall,2012,Jul,1140,6452,7592,Cluster Tinggi
2012-07-25,Fall,2012,Jul,1383,6790,8173,Cluster Tinggi
2012-07-26,Fall,2012,Jul,1036,5825,6861,Cluster Tinggi
2012-07-27,Fall,2012,Jul,1259,5645,6904,Cluster Tinggi
2012-07-28,Fall,2012,Jul,2234,4451,6685,Cluster Tinggi
2012-07-29,Fall,2012,Jul,2153,4444,6597,Cluster Tinggi
2012-07-30,Fall,2012,Jul,1040,6065,7105,Cluster Tinggi
2012-07-31,Fall,2012,Jul,968,6248,7216,Cluster Tinggi
2012-08-01,Fall,2012,Aug,1074,6506,7580,Cluster Tinggi
2012-08-02,Fall,2012,Aug,983,6278,7261,Cluster Tinggi
2012-08-03,Fall,2012,Aug,1328,5847,7175,Cluster Tinggi
2012-08-04,Fall,2012,Aug,2345,4479,6824,Cluster Tinggi
2012-08-05,Fall,2012,Aug,1707,3757,5464,Cluster Sedang
2012-08-06,Fall,2012,Aug,1233,5780,7013,Cluster Tinggi
2012-08-07,Fall,2012,Aug,1278,5995,7273,Cluster Tinggi
2012-08-08,Fall,2012,Aug,1263,6271,7534,Cluster Tinggi
2012-08-09,Fall,2012,Aug,1196,6090,7286,Cluster Tinggi
2012-08-10,Fall,2012,Aug,1065,4721,5786,Cluster Sedang
2012-08-11,Fall,2012,Aug,2247,4052,6299,Cluster Tinggi
2012-08-12,Fall,2012,Aug,2182,4362,6544,Cluster Tinggi
2012-08-13,Fall,2012,Aug,1207,5676,6883,Cluster Tinggi
2012-08-14,Fall,2012,Aug,1128,5656,6784,Cluster Tinggi
2012-08-15,Fall,2012,Aug,1198,6149,7347,Cluster Tinggi
2012-08-16,Fall,2012,Aug,1338,6267,7605,Cluster Tinggi
2012-08-17,Fall,2012,Aug,1483,5665,7148,Cluster Tinggi
2012-08-18,Fall,2012,Aug,2827,5038,7865,Cluster Tinggi
2012-08-19,Fall,2012,Aug,1208,3341,4549,Cluster Sedang
2012-08-20,Fall,2012,Aug,1026,5504,6530,Cluster Tinggi
2012-08-21,Fall,2012,Aug,1081,5925,7006,Cluster Tinggi
2012-08-22,Fall,2012,Aug,1094,6281,7375,Cluster Tinggi
2012-08-23,Fall,2012,Aug,1363,6402,7765,Cluster Tinggi
2012-08-24,Fall,2012,Aug,1325,6257,7582,Cluster Tinggi
2012-08-25,Fall,2012,Aug,1829,4224,6053,Cluster Tinggi
2012-08-26,Fall,2012,Aug,1483,3772,5255,Cluster Sedang
2012-08-27,Fall,2012,Aug,989,5928,6917,Cluster Tinggi
2012-08-28,Fall,2012,Aug,935,6105,7040,Cluster Tinggi
2012-08-29,Fall,2012,Aug,1177,6520,7697,Cluster Tinggi
2012-08-30,Fall,2012,Aug,1172,6541,7713,Cluster Tinggi
2012-08-31,Fall,2012,Aug,1433,5917,7350,Cluster Tinggi
2012-09-01,Fall,2012,Sep,2352,3788,6140,Cluster Tinggi
2012-09-02,Fall,2012,Sep,2613,3197,5810,Cluster Sedang
2012-09-03,Fall,2012,Sep,1965,4069,6034,Cluster Tinggi
2012-09-04,Fall,2012,Sep,867,5997,6864,Cluster Tinggi
2012-09-05,Fall,2012,Sep,832,6280,7112,Cluster Tinggi
2012-09-06,Fall,2012,Sep,611,5592,6203,Cluster Tinggi
2012-09-07,Fall,2012,Sep,1045,6459,7504,Cluster Tinggi
2012-09-08,Fall,2012,Sep,1557,4419,5976,Cluster Tinggi
2012-09-09,Fall,2012,Sep,2570,5657,8227,Cluster Tinggi
2012-09-10,Fall,2012,Sep,1118,6407,7525,Cluster Tinggi
2012-09-11,Fall,2012,Sep,1070,6697,7767,Cluster Tinggi
2012-09-12,Fall,2012,Sep,1050,6820,7870,Cluster Tinggi
2012-09-13,Fall,2012,Sep,1054,6750,7804,Cluster Tinggi
2012-09-14,Fall,2012,Sep,1379,6630,8009,Cluster Tinggi
2012-09-15,Fall,2012,Sep,3160,5554,8714,Cluster Tinggi
2012-09-16,Fall,2012,Sep,2166,5167,7333,Cluster Tinggi
2012-09-17,Fall,2012,Sep,1022,5847,6869,Cluster Tinggi
2012-09-18,Fall,2012,Sep,371,3702,4073,Cluster Sedang
2012-09-19,Fall,2012,Sep,788,6803,7591,Cluster Tinggi
2012-09-20,Fall,2012,Sep,939,6781,7720,Cluster Tinggi
2012-09-21,Fall,2012,Sep,1250,6917,8167,Cluster Tinggi
2012-09-22,Fall,2012,Sep,2512,5883,8395,Cluster Tinggi
2012-09-23,Winter,2012,Sep,2454,5453,7907,Cluster Tinggi
2012-09-24,Winter,2012,Sep,1001,6435,7436,Cluster Tinggi
2012-09-25,Winter,2012,Sep,845,6693,7538,Cluster Tinggi
2012-09-26,Winter,2012,Sep,787,6946,7733,Cluster Tinggi
2012-09-27,Winter,2012,Sep,751,6642,7393,Cluster Tinggi
2012-09-28,Winter,2012,Sep,1045,6370,7415,Cluster Tinggi
2012-09-29,Winter,2012,Sep,2589,5966,8555,Cluster Tinggi
2012-09-30,Winter,2012,Sep,2015,4874,6889,Cluster Tinggi
2012-10-01,Winter,2012,Oct,763,6015,6778,Cluster Tinggi
2012-10-02,Winter,2012,Oct,315,4324,4639,Cluster Sedang
2012-10-03,Winter,2012,Oct,728,6844,7572,Cluster Tinggi
2012-10-04,Winter,2012,Oct,891,6437,7328,Cluster Tinggi
2012-10-05,Winter,2012,Oct,1516,6640,8156,Cluster Tinggi
2012-10-06,Winter,2012,Oct,3031,4934,7965,Cluster Tinggi
2012-10-07,Winter,2012,Oct,781,2729,3510,Cluster Sedang
2012-10-08,Winter,2012,Oct,874,4604,5478,Cluster Sedang
2012-10-09,Winter,2012,Oct,601,5791,6392,Cluster Tinggi
2012-10-10,Winter,2012,Oct,780,6911,7691,Cluster Tinggi
2012-10-11,Winter,2012,Oct,834,6736,7570,Cluster Tinggi
2012-10-12,Winter,2012,Oct,1060,6222,7282,Cluster Tinggi
2012-10-13,Winter,2012,Oct,2252,4857,7109,Cluster Tinggi
2012-10-14,Winter,2012,Oct,2080,4559,6639,Cluster Tinggi
2012-10-15,Winter,2012,Oct,760,5115,5875,Cluster Sedang
2012-10-16,Winter,2012,Oct,922,6612,7534,Cluster Tinggi
2012-10-17,Winter,2012,Oct,979,6482,7461,Cluster Tinggi
2012-10-18,Winter,2012,Oct,1008,6501,7509,Cluster Tinggi
2012-10-19,Winter,2012,Oct,753,4671,5424,Cluster Sedang
2012-10-20,Winter,2012,Oct,2806,5284,8090,Cluster Tinggi
2012-10-21,Winter,2012,Oct,2132,4692,6824,Cluster Tinggi
2012-10-22,Winter,2012,Oct,830,6228,7058,Cluster Tinggi
2012-10-23,Winter,2012,Oct,841,6625,7466,Cluster Tinggi
2012-10-24,Winter,2012,Oct,795,6898,7693,Cluster Tinggi
2012-10-25,Winter,2012,Oct,875,6484,7359,Cluster Tinggi
2012-10-26,Winter,2012,Oct,1182,6262,7444,Cluster Tinggi
2012-10-27,Winter,2012,Oct,2643,5209,7852,Cluster Tinggi
2012-10-28,Winter,2012,Oct,998,3461,4459,Cluster Sedang
2012-10-29,Winter,2012,Oct,2,20,22,Cluster Rendah
2012-10-30,Winter,2012,Oct,87,1009,1096,Cluster Rendah
2012-10-31,Winter,2012,Oct,419,5147,5566,Cluster Sedang
2012-11-01,Winter,2012,Nov,466,5520,5986,Cluster Tinggi
2012-11-02,Winter,2012,Nov,618,5229,5847,Cluster Sedang
2012-11-03,Winter,2012,Nov,1029,4109,5138,Cluster Sedang
2012-11-04,Winter,2012,Nov,1201,3906,5107,Cluster Sedang
2012-11-05,Winter,2012,Nov,378,4881,5259,Cluster Sedang
2012-11-06,Winter,2012,Nov,466,5220,5686,Cluster Sedang
2012-11-07,Winter,2012,Nov,326,4709,5035,Cluster Sedang
2012-11-08,Winter,2012,Nov,340,4975,5315,Cluster Sedang
2012-11-09,Winter,2012,Nov,709,5283,5992,Cluster Tinggi
2012-11-10,Winter,2012,Nov,2090,4446,6536,Cluster Tinggi
2012-11-11,Winter,2012,Nov,2290,4562,6852,Cluster Tinggi
2012-11-12,Winter,2012,Nov,1097,5172,6269,Cluster Tinggi
2012-11-13,Winter,2012,Nov,327,3767,4094,Cluster Sedang
2012-11-14,Winter,2012,Nov,373,5122,5495,Cluster Sedang
2012-11-15,Winter,2012,Nov,320,5125,5445,Cluster Sedang
2012-11-16,Winter,2012,Nov,484,5214,5698,Cluster Sedang
2012-11-17,Winter,2012,Nov,1313,4316,5629,Cluster Sedang
2012-11-18,Winter,2012,Nov,922,3747,4669,Cluster Sedang
2012-11-19,Winter,2012,Nov,449,5050,5499,Cluster Sedang
2012-11-20,Winter,2012,Nov,534,5100,5634,Cluster Sedang
2012-11-21,Winter,2012,Nov,615,4531,5146,Cluster Sedang
2012-11-22,Winter,2012,Nov,955,1470,2425,Cluster Rendah
2012-11-23,Winter,2012,Nov,1603,2307,3910,Cluster Sedang
2012-11-24,Winter,2012,Nov,532,1745,2277,Cluster Rendah
2012-11-25,Winter,2012,Nov,309,2115,2424,Cluster Rendah
2012-11-26,Winter,2012,Nov,337,4750,5087,Cluster Sedang
2012-11-27,Winter,2012,Nov,123,3836,3959,Cluster Sedang
2012-11-28,Winter,2012,Nov,198,5062,5260,Cluster Sedang
2012-11-29,Winter,2012,Nov,243,5080,5323,Cluster Sedang
2012-11-30,Winter,2012,Nov,362,5306,5668,Cluster Sedang
2012-12-01,Winter,2012,Dec,951,4240,5191,Cluster Sedang
2012-12-02,Winter,2012,Dec,892,3757,4649,Cluster Sedang
2012-12-03,Winter,2012,Dec,555,5679,6234,Cluster Tinggi
2012-12-04,Winter,2012,Dec,551,6055,6606,Cluster Tinggi
2012-12-05,Winter,2012,Dec,331,5398,5729,Cluster Sedang
2012-12-06,Winter,2012,Dec,340,5035,5375,Cluster Sedang
2012-12-07,Winter,2012,Dec,349,4659,5008,Cluster Sedang
2012-12-08,Winter,2012,Dec,1153,4429,5582,Cluster Sedang
2012-12-09,Winter,2012,Dec,441,2787,3228,Cluster Sedang
2012-12-10,Winter,2012,Dec,329,4841,5170,Cluster Sedang
2012-12-11,Winter,2012,Dec,282,5219,5501,Cluster Sedang
2012-12-12,Winter,2012,Dec,310,5009,5319,Cluster Sedang
2012-12-13,Winter,2012,Dec,425,5107,5532,Cluster Sedang
2012-12-14,Winter,2012,Dec,429,5182,5611,Cluster Sedang
2012-12-15,Winter,2012,Dec,767,4280,5047,Cluster Sedang
2012-12-16,Winter,2012,Dec,538,3248,3786,Cluster Sedang
2012-12-17,Winter,2012,Dec,212,4373,4585,Cluster Sedang
2012-12-18,Winter,2012,Dec,433,5124,5557,Cluster Sedang
2012-12-19,Winter,2012,Dec,333,4934,5267,Cluster Sedang
2012-12-20,Winter,2012,Dec,314,3814,4128,Cluster Sedang
2012-12-21,Spring,2012,Dec,221,3402,3623,Cluster Sedang
2012-12-22,Spring,2012,Dec,205,1544,1749,Cluster Rendah
2012-12-23,Spring,2012,Dec,408,1379,1787,Cluster Rendah
2012-12-24,Spring,2012,Dec,174,746,920,Cluster Rendah
2012-12-25,Spring,2012,Dec,440,573,1013,Cluster Rendah
2012-12-26,Spring,2012,Dec,9,432,441,Cluster Rendah
2012-12-27,Spring,2012,Dec,247,1867,2114,Cluster Rendah
2012-12-28,Spring,2012,Dec,644,2451,3095,Cluster Rendah
2012-12-29,Spring,2012,Dec,159,1182,1341,Cluster Rendah
2012-12-30,Spring,2012,Dec,364,1432,1796,Cluster Rendah
2012-12-31,Spring,2012,Dec,439,2290,2729,Cluster Rendah
